NO img/north1.xpm
SO img/south1.xpm
WE img/west1.xpm
EA img/east1.xpm

F 220,100,0
C 225,30,0

        11111111111
        1000000000111111111111111
        1011000001100000000000001
        1001000000000000000000001
111111111011000001110000000000001
100000000111111001110111111111111
111100000000000011011100000000001

111100000000000000011101010010001
110000000000000000000000000011111
1000000E000000000000000000001
10000000000000001101010000001
110000011101010111110111000001
11110111 1111111 101111000001
11111111         101111000001
                 111111111111