NO img/north_debug.xpm
SO img/south_debug.xpm
WE img/west_debug.xpm
EA img/east_debug.xpm

F 0,0,50
C 50,0,0

111111111
100000001
100000101
1000E0001
101000001
100000001
111111111