NO img/brick1.xpm
SO img/brick2.xpm
WE img/brick3.xpm
EA img/brick4.xpm

F 55,25,25
C 0,0,55

1111111111111
1000000000001
100000N000001
1000000000001
1000000000001
100000000000111
100000000000001
100000000000001
100000000000001
100000100000001
100000000000111
1000000000001
1111111111111