NO img/north2.xpm
SO img/south2.xpm
WE img/west2.xpm
EA img/east2.xpm


F 150,100,0
C 125,30,0

11111111111111
10001000100101
10000000000001
10E00000000001
10000000000001
10000011111111
1000001
1000001
1000001
1000001
1000001
1000001
1000001
1000001
1000001
1000001
100001
10001
1001
111