NO img/north1.xpm
SO img/south1.xpm
WE img/west1.xpm
EA img/east1.xpm

F 40,36,32
C 20,30,50

1111111111111111111
100000001000100000111111111111111
101110001010101000000000000000001
101111001010101000001100000000001
101000111010001001110001110000001
100010000011111111110110001111111
1111100000001000011100001000000001
1000100111001000000011110000010001
1011100100111000000000000000011111
10000000000100000000000000001
100000000111111000110111111111111
111110000100000110001100000000001
100010000100000001101101010010001
100000000000000000100100000011111
10001000010000000001010000001
100010000111111111110111111111111
100010000000000011010100000000001
111110001000100000000100110010001
100100001000111111111100000011111
10010S00000000000000000000001
10000000000000001101010000001
11110001110000011111101110001
10000011 1111111 100000000001
11111111         111111111111