NO img/north1.xpm
SO img/south1.xpm
WE img/west1.xpm
EA img/east1.xpm

F 40,36,32
C 20,30,50

111111T111111111111
10000000100010000011111111T111111
1011T000101010T00000000000000000T
101111001010T01000001100000000001
10T0001110100010011100011T0000001
100010000011111111110110001111111
11111000000010000T1100001000000001
10001001110010000000111T000001000T
1011100T0011100000000000000001T111
T000000000010000000000000000T
100000000T11111000T1011111111TT11
111110000100000110001100000000001
100010000100000001101101010010001
100000000000000000100100000011111
100010000T0000000001010000001
100010000111111111110111111111111
10001000000000001T010100000000001
11111T001000T000000001001100T0001
100100001000111111111T00000011111
100T0S00100000000000000000001
1000000000000000T101010000001
111T0001T1000001111110111000T
1000001T 1111111 100000000001
11111111         111111111111