NO img/wolfenstein/brick.xpm
SO img/wolfenstein/mossy.xpm
WE img/wolfenstein/stone.xpm
EA img/wolfenstein/eagle.xpm

F 0,0,35
C 0,25,0

        11111111111
        1000000000111111111111111
        1011000001100000000000001
        1001000000000000011110001
111111111011000001110000010000001
100000000011111001110111010111111
11110111111   1111011000010000001
1111011111    1111010001110000001
110000011111      110111000011111
1000000E0001      10000000001
10011000000111111111010000001
11011000000000000000000000001
110000011101000111110010000001
11110111 1111111 101111000001
11111111         100000000001
                 111111111111