NO img/north1.xpm
SO img/south1.xpm
WE img/west1.xpm
EA img/east1.xpm

F 0,50,0
C 125,30,0

111111111111111111111111
100100100100100100100001
100100100100100100100001
100100100100100100100001
100000000000000000000001
111111111111111111000011
100001000000000001000011
111101011110011101000001
100100010010000101100001
100101110111110100000011
100101010100010101100011
10011101010E010101000001
100000010000010101000001
100000010111110100000011
100000010000000100000011
100000011111111111100001
100000000000000000000001
100000000000000000000011
100000000000000000000011
100000000000000000000001
110000000000000000000011
111100000000000000011111
111111100000000011111111
111111111111111111111111