NO img/north2.xpm
SO img/south2.xpm
WE img/west2.xpm
EA img/east2.xpm

F 0,50,0
C 125,30,0

111111111111111111111111
100100100100100100100001
100100100100100100100001
100100100100100100100001
100000000000000000000001
100000000000000000000011
100000000000000000000011
100000000000000000000001
100000000000000000000001
100000000000000000000011
100000000000000000000011
10000000000E000000000001
100000000000000000000001
100000000000000000000011
100000000000000000000011
100000000000000000000001
100000000000000000000001
100000000000000000000011
100000000000000000000011
100000000000000000000001
110000000000000000000011
111100000000000000011111
111111100000000011111111
111111111111111111111111