NO img/wolfenstein/brick.xpm
SO img/wolfenstein/mossy.xpm
WE img/wolfenstein/stone.xpm
EA img/wolfenstein/eagle.xpm

F 0,0,35
C 0,25,0

        11111111111
        1000000000111111111111111
        1011000001100000000000001
        1001000000000000011112111
111111111011000001110000010000001
100200000011111001110111012111111
10010111111   1111011000010000001
1001011111    1111010001110000001
111121011111      112111001211111
100000000001      10000000001
11211000W00111111111010000001
10001000000000020000000000001
100020011101000111110010000001
10001111 1111111 101111000001
11111111         100000000001
                 111111111111